0 0 0 0 0 0 0 0 0 0 0 0 0 0 0 0 0 0 0 0 0 0 0 0 0 0
0 0 0 0 0 0 0 0 0 0 0 0 0 0 0 0 0 0 0 0 0 0 0 0 0 0
1 1 1 1 1 1 1 1 1 1 1 1 1 1 1 1 1 1 1 1 1 1 1 1 1 1
1 1 1 1 1 1 1 1 1 1 1 1 1 1 1 1 1 1 1 1 1 1 1 1 1 1
1 1 1 1 1 1 1 1 1 1 1 1 1 1 1 1 1 1 1 1 1 1 1 1 1 1
1 1 1 1 1 1 1 1 1 1 1 1 1 1 1 1 1 1 1 1 1 1 1 1 1 1
1 1 1 1 1 1 4 4 4 4 3 3 3 3 3 3 4 4 4 4 1 1 1 1 1 1
1 1 1 1 1 1 4 4 4 4 4 4 2 2 4 4 4 4 4 4 1 1 1 1 1 1
1 1 1 1 1 1 4 4 4 4 4 4 2 2 4 4 4 4 4 4 1 1 1 1 1 1
1 1 1 1 1 1 4 4 4 4 4 4 2 2 4 4 4 4 4 4 1 1 1 1 1 1
1 1 1 1 1 1 4 4 4 4 4 4 2 2 4 4 4 4 4 4 1 1 1 1 1 1
5 5 5 5 5 5 4 4 4 4 4 4 2 2 4 4 4 4 4 4 5 5 5 5 5 5
5 5 5 5 5 5 4 4 4 4 4 4 2 2 4 4 4 4 4 4 5 5 5 5 5 5
1 1 1 1 1 1 4 4 4 4 4 4 2 2 4 4 4 4 4 4 1 1 1 1 1 1
1 1 1 1 1 1 4 4 4 4 4 4 2 2 4 4 4 4 4 4 1 1 1 1 1 1
1 1 1 1 1 1 4 4 4 4 4 4 2 2 4 4 4 4 4 4 1 1 1 1 1 1
1 1 1 1 1 1 4 4 4 4 4 4 2 2 4 4 4 4 4 4 1 1 1 1 1 1
1 1 1 1 1 1 4 4 4 4 3 3 3 3 3 3 4 4 4 4 1 1 1 1 1 1
1 1 1 1 1 1 1 1 1 1 1 1 1 1 1 1 1 1 1 1 1 1 1 1 1 1
1 1 1 1 1 1 1 1 1 1 1 1 1 1 1 1 1 1 1 1 1 1 1 1 1 1
1 1 1 1 1 1 1 1 1 1 1 1 1 1 1 1 1 1 1 1 1 1 1 1 1 1
1 1 1 1 1 1 1 1 1 1 1 1 1 1 1 1 1 1 1 1 1 1 1 1 1 1
5 5 5 5 5 5 0 0 0 0 1 1 1 1 1 1 0 0 0 0 5 5 5 5 5 5
5 5 5 5 5 5 0 0 0 0 1 1 1 1 1 1 0 0 0 0 5 5 5 5 5 5
5 5 5 5 5 5 0 0 0 0 1 1 6 7 1 1 0 0 0 0 5 5 5 5 5 5
5 5 5 5 5 5 0 0 0 0 1 1 8 9 1 1 0 0 0 0 5 5 5 5 5 5